{
  "layout": [
    "999911111111111111111111119999",
    "999111111222222222222111111999",
    "999111112222222222222211111999",
    "999111112222222222222211111999",
    "999111122222233332222221111999",
    "991111122222333333222221111199",
    "911111222223333333322222111119",
    "111111222223333333322222111111",
    "111112222223333333322222211111",
    "111112222223333333322222211111",
    "111111222223333333322222111111",
    "111111122223333333322221111111",
    "911111112222233332222211111119",
    "991111112222222222222211111199",
    "991111111222222222222111111199",
    "999111111122222222221111111999",
    "999111111111222222111111111999",
    "999991111111111111111111199999",
    "999999911111111111111119999999",
    "999999991111111111111199999999"
  ],
  "chairs": 500,
  "roomType": 3,
  "vacancy": [
    "000000000000000000000000000000",
    "000000000000000000000000000000",
    "000000000000000000000000000000",
    "000000000000000000000000000000",
    "000000000000000000000000000000",
    "000000000000000000000000000000",
    "000000000000000000000000000000",
    "000000000000000000000000000000",
    "000000000000000000000000000000",
    "000000000000000000000000000000",
    "000000000000000000000000000000",
    "000000000000000000000000000000",
    "000000000000000000000000000000",
    "000000000000000000000000000000",
    "000000000000000000000000000000",
    "000000000000000000000000000000",
    "000000000000000000000000000000",
    "000000000000000000000000000000",
    "000000000000000000000000000000",
    "000000000000000000000000000000"
  ]
}