{
  "layout": [
    "001111111100",
    "011111111110",
    "011111111110",
    "111112211111",
    "111122221111",
    "112223322211",
    "112233332211",
    "112223322211",
    "111122221111",
    "111112211111",
    "011111111110",
    "001111111100",
    "001111111100",
    "001111111100"
  ],
  "chairs": 126,
  "roomType": 2,
  "vacancy": [
    "000000000000",
    "000000000000",
    "000000000000",
    "000000000000",
    "000000000000",
    "000000000000",
    "000000000000",
    "000000000000",
    "000000000000",
    "000000000000",
    "000000000000",
    "000000000000",
    "000000000000",
    "000000000000"
  ]
}