{
  "layout": [
    "123123123123123123",
    "911111222222111119",
    "911112222222211119",
    "911112222222211119",
    "911122222222221119",
    "911122223322221119",
    "111222233332222111",
    "111222333333222111",
    "112222333333222211",
    "112222333333222211",
    "112222333333222211",
    "911222233332222119",
    "911122223322221119",
    "911112222222211119",
    "991111222222111199",
    "991111222222111199",
    "991111111111111199",
    "999111111111111999",
    "999111111111111999"
  ],
  "chairs": 120,
  "roomType": 2,
  "vacancy": [
    "110000000000000000",
    "000000000000000000",
    "000000000000000000",
    "000000000000000000",
    "000000000000000000",
    "000000000000000000",
    "000000111110000000",
    "000000000000000000",
    "000001110000000000",
    "000000000000000000",
    "000000000000000000",
    "000000000000000000",
    "000000000000000000",
    "000000000000000000",
    "000000000000000000",
    "000000000000000000",
    "000000000000000000",
    "000000000000000000",
    "000000000000000000"
  ]
}