{
  "layout": [
    "991111111199",
    "911111111119",
    "911111111119",
    "111112211111",
    "111122221111",
    "112223322211",
    "112233332211",
    "112223322211",
    "111122221111",
    "111112211111",
    "911111111119",
    "991111111199",
    "991111111199",
    "991111111199"
  ],
  "chairs": 120,
  "roomType": 3,
  "vacancy": [
    "001111001100",
    "000000000000",
    "001110000000",
    "000000000000",
    "000000000000",
    "000000000000",
    "000000000000",
    "000000000000",
    "000000000000",
    "000000000000",
    "000000000000",
    "000000000000",
    "000000000000",
    "000000000000"
  ]
}